# Setting
Setting=Wallpaper Setting
settingOk=OK
settingCancel=Cancel

# Video
videoLabel=Video
videoBrowser=Browser

# Wallpaper
wallpaperLabel=Wallpaper
wallpaperAutorun=Run at startup
wallpaperMenu=Desktop right-click menu
wallpaperExclude=Enable exclude

# Mpv
mpvLabel=Mpv
mpvAudio=Use Audio output

# Stop
exitClose=Exit
exitClear=Cleanup

# Exclude
excludeLabel=Exclude
excludeAdd=Add
excludeDelete=Delete

# Message
information=Information
warning=Warning
error=Error
closeMessage=Change not saved, are you sure to close?
exitMessage=Are you sure to clear and exit "Wallpaper"?
exitDone=Cleanup completed.
stopTipText=Click "Help" to enable "Clear".
mpvMessage=Can't find "Mpv" application.
fileMessage=Can't find video file.
